NO ./textures/stone_grey.xpm
SO ./textures/stone_grey.xpm
WE ./textures/stone_grey.xpm
EA ./textures/stone_grey.xpm
DO ./textures/wood_planks.xpm
F 35,35,35
C 150,150,170
11111111111111111111
1N000000000000000001
10111111111111111001
10100000000000001001
10101111111111101001
10101000000000101001
10101011111110101001
10101010000010101001
10101010111010101001
10101010101010101001
10101010101010101001
10101010111010101001
10101010000010101001
10101011111110101001
10101000000000101001
10101111111111101001
10100000000000001001
10111111111111111001
10000000000000000001
11111111111111111111


