NO ./textures/north.xpm
SO ./textures/south.xpm
WE ./textures/west.xpm
EA ./textures/east.xpm
DO ./textures/door.xpm
F 60,60,60
C 180,200,220

111111111111111111111111111111111
1N0000000010000000000000000000001
111011111010111111111101111110101
100010000010000000001001000010001
101110111111011111101101011110111
100000100000010000100001000000001
111110101111110111101111011111101
100000101000000100D01000010000001
101111101011111101111011110111101
100000001000000100000010000010001
111111101111110111111011111010111
100000101000010100000010000010001
101110101011010111110111011010111
100010100010010000010001010010001
111010111110011111010111010111101
100010000000000000010001010000001
101111111111111111111011011111101
100000000000000000000010000000001
111111111111111111111111111111101


