NO ./textures/north.xpm
SO ./textures/south.xpm
WE ./textures/west.xpm
EA ./textures/east.xpm
F 30,60,30
C 160,200,255

111111111111111111111111111111111111
1N0000000000000000000000000000000001
101111111111111111111111111111110101
101000000000000000000000000000010001
101011111111111111111111111110011101
101010000000000000000000000010000001
101010111111111111011111111011111101
101010100000000001010000001000000001
101010101111111101010111101111111101
101010101000001001010100001000000001
101010101011101101010101101011111101
101010101010001001010101001000000001
101010101010111101010101101111111101
101010101010001001000101000000000001
101010101011101111110111111111110101
100010100010000000000000000000010101
111110111110111111111111111111010101
100000000000100000000000000001010001
111111111111111111111111111111111111


