NO ./textures/north.xpm
SO ./textures/south.xpm
WE ./textures/west.xpm
EA ./textures/east.xpm
DO ./textures/door.xpm
F 40,40,40
C 200,210,220

111111111111111111111111111111
1N0000000000000010000000000001
101D11111111110101111111111101
101T00000000010100000000000101
101011111110010111111111110101
10101000001T010100000001010101
10101011101T010101111101010101
101010101010010D01000101010101
10101010101001010101T10101T101
10101010101001010101010101T101
10101010101000000101010101T101
10101010101111110101010101T101
10101010000000000100010101T101
10101111111111111111010101T101
101000000000000000010101010001
101111111111111D11110101011101
100000000000110000000100000001
111111111111111111111111111111


