NO ./textures/north.xpm
SO ./textures/south.xpm
WE ./textures/west.xpm
EA ./textures/east.xpm
DO ./textures/door.xpm
F 40,40,40
C 200,210,220

111111111111111111111111111111
1N0000000000000010000000000001
101D11111111110101111111111101
101000000000010100000000000101
101011111110010111111111110101
101010000010010100000001010101
101010111010010101111101010101
101010101010010D01000101010101
101010101010010101010101010101
101010101010010101010101010101
101010101010000001010101010101
101010101011111101010101010101
101010100000000001000101010101
101011111111111111110101010101
101000000000000000010101010001
101111111111111111110101011101
100000000000110000000100000001
111111111111111111111111111111


