NO ./textures/marble_white.xpm
SO ./textures/marble_white.xpm
WE ./textures/stone_grey.xpm
EA ./textures/wood_planks.xpm
F 40,40,40
C 180,180,190
1111111111111111
1N00000000100001
1011111010111101
1010001010000101
1010101011110101
1010101000010101
1010111111010101
1010000000010101
1010111111110101
1010000000000101
1011111111111101
1000000000000001
1111111111111111


